1000,4,5,1800,700,300,1,0,0
1000,4,5,1900,700,300,1,0,0
1000,4,5,2000,700,300,1,0,0
200,0,1500,360,10,30,1,0,0
300,2,5,1600,360,1650,360,10,1
400,3,5,1700,360,1,0,0,0
500,4,5,1800,700,300,1,0,0
600,5,5,1900,650,1,0,0,0
700,8,5,2000,360,1,0,0,0
800,9,5,2100,360,1,0,0,0
900,10,5,2200,650,1,0,0,0
1000,11,5,2300,300,1,0,0,0
1100,12,5,2400,650,1,0,0,0
1200,13,5,2500,650,1,0,0,0
1300,17,5,2600,300,1,0,0,0
1400,20,5,2700,360,1,0,0,0
